SO ./xpm/NO.xpm
WE ./xpm/SO.xpm
NO ./xpm/W.xpm

F                                     225,                30,                      0
C 220,100,255

EA  ./        x              p          m/          .xp
     1111
     1101
     1001
     1011
     111111111
1111   10N01
1111    1111111